Setlist "Los 40 Principales Karaoke Party"

Alejandro Sanz - Mi marciana
Alejandro Sanz - No me compares
Antonio Orozco - Templando
Auryn - Heartbreaker
Bruno Mars - Locke Out of Heaven
Cali y El Dandee - No digas nada
Christina Perri - Human
Clean Pandit - Rather Be
Coldplay - A Sky Full of Stars
David Bisbal - Diez mil maneras
Efecto Mariposa - Por quererte
Efecto Pasillo - No importa que llueva
Ellie Goulding - Burn
Fito y Fitipaldis - Antes de que cuente diez
Icono Pop feat. Charli XCX - I Love It
Imagine Dragons - On Top of the World
James Arthur - Impossible
James Blunt - Bonfire Heart
John Newman - Love Me Again
Juanes - Mil pedazos
La Quinta Estación feat. Marc Anthony - Recuérdame
Lady Gaga - Born This Way
Lagarto Amarillo - Culpable
Lilly Wood & The Prick w. Robin Schulz - Prayer in C
Loreen - Euphoria
Love of Lesbian - Allí donde solíamos gritar
Manuel Carrasco - No dejes de sonar
Marc Anthony - Vivir mi vida
Melendi - Tu jardín con enanito
Naughty Boy feat. Sam Smith - La La La
Nena Davonte - Tenía tanto que darte
Nico & Vinz - Am I Wrong?
OneRepublic - Counting Stars
Pablo López - Vi
Passenger - Let Her Go
Pharrell Williams - Happy
Rasel - Viven
Ricky Martin - Come With Me
Rulo y la Contrabanda - Mi pequeña cicatriz
Swedish House Mafia feat. John Martin - Don’t You Worry Child
